11 01 01 01 01 01 01 01 01 01 01 01 01 01 01 01
11 01 01 01 01 01 01 01 01 01 01 01 01 01 01 01
11 01 01 01 01 01 01 01 01 01 01 01 01 00 01 01
11 01 01 01 01 01 01 01 01 01 01 01 01 01 01 01
11 01 01 01 01 01 01 01 01 01 01 01 01 01 01 01
11 01 01 01 01 01 01 01 01 01 01 01 01 01 01 01
11 01 01 01 01 01 01 01 01 01 01 01 01 01 01 01
11 01 01 01 01 01 01 01 00 01 01 01 01 01 01 01
11 01 01 01 01 01 01 01 01 01 01 01 01 01 01 01
11 01 01 01 01 01 01 01 01 01 01 01 01 01 01 01
11 01 01 01 01 01 01 01 01 01 01 01 01 01 01 01
11 01 01 01 01 01 01 01 01 01 01 01 01 01 01 01
11 01 01 01 01 01 01 01 01 01 01 01 01 01 01 01
11 01 01 01 01 01 01 01 01 01 01 01 01 01 01 01
11 01 01 01 01 01 01 01 01 01 01 01 01 01 01 01
11 01 01 01 01 01 01 01 01 01 01 01 01 01 01 01
